


void zdc_map_online(){
int side_db[16][16] = {
59	    {0,0,0,0,0,0,0,0,0,0,0,0,0,0,0,0},
60	    {0,0,0,0,0,0,0,0,0,0,0,0,0,0,0,0},
61	    {0,0,0,0,0,0,0,0,0,0,0,0,0,0,0,0},
62	    {0,0,0,0,0,0,0,0,0,0,0,0,0,0,0,0},
63	    {0,0,0,0,0,0,0,0,0,0,0,0,0,0,0,0},
64	    {0,0,0,0,0,0,0,0,0,0,0,0,0,0,0,0},
65	    {0,0,0,0,0,0,0,0,0,0,0,0,0,0,0,0},
66	    {0,0,0,0,0,0,0,0,0,0,0,0,0,0,0,0},
67	    {0,0,0,0,0,0,0,0,0,0,0,0,0,0,0,0},
68	    {0,0,0,0,0,0,0,0,0,0,0,0,0,0,0,0},
69	    {0,0,0,0,0,0,0,0,0,0,0,0,0,0,0,0},
70	    {0,0,0,0,0,0,0,0,0,0,0,0,0,0,0,0},
71	    {1,1,1,1,1,1,1,1,1,1,1,1,1,1,1,1},
72	    {1,1,1,1,1,1,1,1,1,1,1,1,1,1,1,1},
73	    {1,1,1,1,1,1,1,1,1,1,1,1,1,1,1,1},
74	    {1,1,1,1,1,1,1,1,1,1,1,1,1,1,1,1}
75	  };

}
